"Family (Scientific)"	"Family (English)"	"Code"	"Comment"
"Tinamidae"	"Tinamous"	"."	"."
"Struthionidae"	"Ostriches"	"."	"."
"Rheidae"	"Rheas"	"."	"."
"Casuariidae"	"Cassowaries"	"."	"."
"Dromaiidae"	"Emu"	"."	"."
"Apterygidae"	"Kiwis"	"."	"."
"Anhimidae"	"Screamers"	"."	"."
"Anseranatidae"	"Magpie Goose"	"."	"."
"Anatidae"	"Ducks, Geese and Swans"	"."	"."
"Megapodiidae"	"Megapodes"	"."	"."
"Cracidae"	"Chachalacas, Curassows and Guans"	"."	"."
"Numididae"	"Guineafowl"	"."	"."
"Odontophoridae"	"New World Quail"	"."	"."
"Phasianidae"	"Pheasants and allies"	"."	"."
"Gaviidae"	"Loons"	"."	"."
"Spheniscidae"	"Penguins"	"."	"."
"Diomedeidae"	"Albatrosses"	"TAX"	"The species taxonomy of albatrosses is controversial with advocates for 12 to 24 species (BLI, Tennyson 2010, SACC 388, Penhallurick 2012)"
"Procellariidae"	"Petrels, Shearwaters"	"."	"."
"Hydrobatidae"	"Storm Petrels"	"TAX, PHY"	"The subfamilies Hydrobatinae and Oceanitinae may not be sister taxa and could be treated as separate families (Nunn & Stanley 1998; Penhallurick & Wink 2004, Hackett et al. 2008)"
"Pelecanoididae"	"Diving Petrels"	"."	"."
"Podicipedidae"	"Grebes"	"."	"."
"Phoenicopteridae"	"Flamingos"	"."	"."
"Phaethontidae"	"Tropicbirds"	"."	"."
"Ciconiidae"	"Storks"	"."	"."
"Threskiornithidae"	"Ibises, Spoonbills"	"PHY"	"Ibises and spoonbills (Threskiornithidae) and herons (Ardeidae) are sister taxa in the Order Pelecaniformes (Hackett et al. 2008)"
"Ardeidae"	"Herons, Bitterns"	"PHY"	"The herons (Ardeidae) and ibises,spoonbills (Threskiornithidae) are sister taxa in the Order Pelecaniformes (Hackett et al. 2008)"
"Scopidae"	"Hamerkop"	"."	"."
"Balaenicipitidae"	"Shoebill"	"."	"."
"Pelecanidae"	"Pelicans"	"."	"."
"Fregatidae"	"Frigatebirds"	"."	"."
"Sulidae"	"Gannets, Boobies"	"."	"."
"Phalacrocoracidae"	"Cormorants, Shags"	"TAX"	"The genera of cormorants and the distinctions between ""shags"" and ""cormorants"" remain mostly unresolved due to conflicts among studies and missing taxa (Siegel-Causey 1988, Kennedy et al 2000, Christidis &  Boles 2008). Except for species of Microcarbo"
"Anhingidae"	"Anhingas, Darters"	"."	"."
"Cathartidae"	"New World Vultures"	"TAX"	"SACC 361 elevates the New World Vultures (Cathartidae) to a separate order, the Cathartiformes"
"Sagittariidae"	"Secretarybird"	"TAX"	"RESTORE: Secretarybird to a monotypic family Sagittariidae in accord with the Tree of Life phylogeny (Hackett et al. 2008)"
"Pandionidae"	"Ospreys"	"TAX"	"RESTORE: Ospreys to the family Pandionidae in accord with the Tree of Life phylogeny (Hackett et al. 2008)"
"Accipitridae"	"Kites, Hawks and Eagles"	"TAX,PHY"	"Classification of Accipitridae revised v3.3; see especially Wink & Sauer-Gürth 2004, Lerner & Mindell 2005, TIF)"
"Otididae"	"Bustards"	"."	"."
"Mesitornithidae"	"Mesites"	"."	"."
"Cariamidae"	"Seriemas"	"."	"."
"Rhynochetidae"	"Kagu"	"PHY"	"The Kagu (Rhynochetidae) and Sunbittern (Eurypygidae) are sister taxa (Hackett et al. 2008)."
"Eurypygidae"	"Sunbittern"	"."	"."
"Sarothruridae"	"Flufftails"	"PHY"	"The flufftails (Sarothruridae) and finfoots (Heliornithidae) are sister taxa (Hackett et al. 2008)"
"Heliornithidae"	"Finfoots"	"PHY"	"The finfoots (Heliornithidae) and flufftails (Sarothruridae) are sister taxa (Hackett et al. 2008)"
"Rallidae"	"Rails, Crakes and Coots"	"."	"."
"Psophiidae"	"Trumpeters"	"."	"."
"Gruidae"	"Cranes"	"."	"."
"Aramidae"	"Limpkin"	"."	"."
"Turnicidae"	"Buttonquail"	"PHY"	"The buttonquails (Turnicidae) belong in the Charadriiformes, not the Gruiformes (Hackett et al. 2008)"
"Burhinidae"	"Stone-curlews, Thick-knees"	"."	"."
"Chionidae"	"Sheathbills"	"."	"."
"Pluvianellidae"	"Magellanic Plover"	"TAX"	"The Magellanic Plover (Pluvianellus) is most closely related to the sheathbills (Chionidae) (REF), but is treated as a monotypic family by the SACC."
"Haematopodidae"	"Oystercatchers"	"."	"."
"Dromadidae"	"Crab-plover"	"."	"."
"Ibidorhynchidae"	"Ibisbill"	"."	"."
"Recurvirostridae"	"Stilts, Avocets"	"."	"."
"Charadriidae"	"Plovers"	"."	"."
"Pluvianidae"	"Egyptian Plover"	"PHY, TAX"	"Move  Egyptian Plover (Pluvianus) from the Glareolidae to its own family tentatively named ""Pluvianidae"". It is a separate lineage that is the outgroup to plovers and their allies (Baker et al 2007, Hackett et al. 2008)"
"Rostratulidae"	"Painted-snipes"	"."	"."
"Jacanidae"	"Jacanas"	"."	"."
"Pedionomidae"	"Plains-wanderer"	"."	"."
"Thinocoridae"	"Seedsnipes"	"."	"."
"Scolopacidae"	"Sandpipers, Snipes"	"."	"."
"Glareolidae"	"Coursers, Pratincoles"	"."	"."
"Laridae"	"Gulls, Terns and Skimmers"	"PHY, TAX"	"The skimmers Rynchops and terns are embedded among the gulls in a monophyletic clade; separation of the families Rynchopidae and Sternidae would render the gull family Laridae paraphyletic relative to these other two groups (Baker et al. 2008,Ödeen"
"Stercorariidae"	"Skuas"	"."	"."
"Alcidae"	"Auks"	"."	"."
"Pteroclidae"	"Sandgrouse"	"."	"."
"Columbidae"	"Pigeons, Doves"	"."	"."
"Opisthocomidae"	"Hoatzin"	"."	"."
"Musophagidae"	"Turacos"	"."	"."
"Cuculidae"	"Cuckoos"	"."	"."
"Tytonidae"	"Barn Owls"	"."	"."
"Strigidae"	"Owls"	"."	"."
"Podargidae"	"Frogmouths"	"TAX"	"Recognition of the Asian frogmouths (Batrachosomus) vs Australasian frogmouths (Podargus) as separate families (Christidis and Boles 2008) requires equal consideration for Rigidipenna inexpectatus as a monotypic family (see Tree of Life)"
"Steatornithidae"	"Oilbird"	"."	"."
"Nyctibiidae"	"Potoos"	"."	"."
"Caprimulgidae"	"Nightjars"	"PHY"	"The eared nightjars Eurostopodus are the sister taxon to rest of the Caprimulgidae (Barrowclough et al 2006, Larsen et al. 2007), but they are not equivalent in rank to other families in the Caprimulgiformes."
"Aegothelidae"	"Owlet-nightjars"	"PHY"	"The owlet-nightjars (Aegothelidae) are the sister taxon to treeswifts and in turn to the swifts and hummingbirds; hence are included in the Apodiformes (Hackett et al. 2008, Christidis and Boles 2008)"
"Hemiprocnidae"	"Treeswifts"	"."	"."
"Apodidae"	"Swifts"	"."	"."
"Trochilidae"	"Hummingbirds"	"."	"."
"Coliidae"	"Mousebirds"	"."	"."
"Trogonidae"	"Trogons"	"SEQ"	"Sequence of New World trogons follows AOU in accord with DaCosta and Klicka (2008) and Moyle (2005)"
"Leptosomidae"	"Cuckoo Roller"	"TAX"	"The correct spelling of this family name is Leptosomidae, not Leptosomatidae (Bock 1994)"
"Coraciidae"	"Rollers"	"."	"."
"Brachypteraciidae"	"Ground Rollers"	"."	"."
"Alcedinidae"	"Kingfishers"	"TAX"	"The kingfishers (Alcedinidae) comprise three monophyletic clades (Alcedininae, Cerylinae, and Daceloninae) (Moyle 2006); some taxonomists elevate them to family status (Sibley and Monroe 1990, Christidis and Boles 2008)"
"Todidae"	"Todies"	"."	"."
"Momotidae"	"Motmots"	"."	"."
"Meropidae"	"Bee-eaters"	"."	"."
"Upupidae"	"Hoopoes"	"PHY"	"The hoopoes (Upupidae) and wood hoopoes (Phoeniculidae) are sister taxa related in turn to the hornbills (Hackett et al. 2008)"
"Phoeniculidae"	"Wood Hoopoes"	"PHY"	"The hoopoes (Upupidae) and wood hoopoes (Phoeniculidae) are sister taxa related in turn to the hornbills (Hackett et al. 2008)"
"Bucerotidae"	"Hornbills"	"PHY"	"The hornbills (Bucerotidae) and ground hornbills (Bucorvidae) are sister taxa related in turn to the hoopoes and wood hoopoes (Hackett et al. 2008)"
"Bucorvidae"	"Ground Hornbills"	"PHY"	"The hornbills (Bucerotidae) and ground hornbills (Bucorvidae) are sister taxa related in turn to the hoopoes and wood hoopoes (Hackett et al. 2008)"
"Galbulidae"	"Jacamars"	"PHY"	"The jacamars (Galbulidae) and puffbirds (Bucconidae) are well-established sister taxa (SACC,Hackett et al. 2008), with evidence favoring inclusion in the Piciformes, rather than a separate Order Galbuliformes (TOL, Ericson et al. 2006; cf SACC, Fain & Hou"
"Bucconidae"	"Puffbirds"	"PHY"	"The jacamars (Galbulidae) and puffbirds (Bucconidae) are well-established sister taxa (SACC,Hackett et al. 2008), with evidence favoring inclusion in the Piciformes, rather than a separate Order Galbuliformes (TOL, Ericson et al. 2006; cf SACC, Fain & Hou"
"Capitonidae"	"New World Barbets"	"PHY"	"Toucans and New World barbets are sister taxa  (Moyle 2004, SACC 7) elevated to separate families to reflect their phylogeny (NACC 2010)"
"Semnornithidae"	"Toucan Barbets"	"."	"."
"Ramphastidae"	"Toucans"	"."	"."
"Megalaimidae"	"Asian Barbets"	"PHY"	"Asian barbets (Megalaimidae) are the basal outgroup to the African barbets and in turn the New World barbets and toucans (Moyle 2004)"
"Lybiidae"	"African Barbets"	"PHY"	"African barbets (Lybiidae) are sisters to the New World barbets and toucans (Moyle 2004)"
"Indicatoridae"	"Honeyguides"	"PHY"	"Honeyguides (Indicatoridae) and woodpeckers (Picidae) are sister families (Hackett et al. 2008)"
"Picidae"	"Woodpeckers"	"."	"."
"Falconidae"	"Caracaras, Falcons"	"."	"."
"Strigopidae"	"New Zealand Parrots"	"PHY"	"The New Zealand parrots (Nestoridae) are a basal lineage that is sister to all other parrots (Psittacidae); elevate to family status (Christidis and Boles 2008). Strigopidae has precedence over Nestoridae (J Boyd, A Peterson)"
"Cacatuidae"	"Cockatoos"	"TAX"	"Cockatoos are treated as a family separate from other parrots (Psittacidae) following Christidis and Boles (2008)"
"Psittacidae"	"Parrots"	"."	"."
"Acanthisittidae"	"New Zealand Wrens"	"PHY"	"New Zealand wrens are sister to the rest of the Passeriformes"
"Eurylaimidae"	"Broadbills"	"PHY"	"The broadbills (family Eurylaimidae) include both the asities of Madagascar and Sapayoa of the New World, and together are the sister group to the pittas (Pittidae) (Irestedt et al. 2006; Moyle 2006a);  Retention of asities and Sapayoa in their own respec"
"Pittidae"	"Pittas"	"."	"."
"Furnariidae"	"Ovenbirds"	"TAX"	"The ovenbird family Furnariidae includes the phylogenetically embedded woodcreepers, formerly separated as the family Dendrocolaptidae (SACC 132)"
"Thamnophilidae"	"Antbirds"	"."	"."
"Formicariidae"	"Antthrushes"	"."	"."
"Grallariidae"	"Antpittas"	"PHY"	"The antpittas (Grallariidae) are not closely related to the antthrushes (Formicariidae) and thus are treated as a separate family (Chesser 2004, Rice 2005, SACC)"
"Conopophagidae"	"Gnateaters"	"."	"."
"Rhinocryptidae"	"Tapaculos"	"."	"."
"Melanopareiidae"	"Crescentchests"	"PHY, TAX"	"The crescentchests are not tapaculos, but a separate family Melanopareiidae that is one of four basal lineages of  furnariine suboscines  (Chesser 2004, Moyle et al. 2009)"
"Tyrannidae"	"Tyrant Flycatchers"	"."	"."
"Cotingidae"	"Cotingas"	"."	"."
"Pipridae"	"Manakins"	"."	"."
"Tityridae"	"Tityras, Becards"	"PHY"	"The genera placed in the family Tityridae are more closely related to the manakins (Pipridae) than to the cotingas (Cotingidae) (Chesser 2004, Barber and Rice 2007, SACC)"
"Incertae Sedis 1"	"Family Uncertain"	"."	"."
"Menuridae"	"Lyrebirds"	"."	"."
"Atrichornithidae"	"Scrubbirds"	"."	"."
"Ptilonorhynchidae"	"Bowerbirds"	"."	"."
"Climacteridae"	"Australasian Treecreepers"	"."	"."
"Maluridae"	"Australasian Wrens"	"."	"."
"Meliphagidae"	"Honeyeaters"	"PHY, TAX"	"Remove Moho to Mohoidae and Notiomystis to Notiomystidae. Revised classification (3.4) of genera and breakup of Lichenostomus follows Nyári & Joseph (2011)."
"Dasyornithidae"	"Bristlebirds"	"."	"."
"Pardalotidae"	"Pardalotes"	"."	"."
"Acanthizidae"	"Australasian Warblers"	"."	"."
"Pomatostomidae"	"Australasian Babblers"	"."	"."
"Orthonychidae"	"Logrunners"	"."	"."
"Cnemophilidae"	"Satinbirds"	"."	"."
"Melanocharitidae"	"Berrypeckers, Longbills"	"."	"."
"Paramythiidae"	"Painted Berrypeckers"	"PHY"	"Separate the painted berrypeckers (Oreocharis and Paramythia) from the Melanocharitidae to the Paramythiidae  (Barker et al 2004; HBW)"
"Callaeidae"	"New Zealand Wattlebirds"	"TAX, ENG"	"Correct spelling of family name is ""Callaeidae"", not ""Callaeatidae"" (Bock 1994, H&M Corrigenda); Change family name to New Zealand Wattlebirds per NZ Checklist Committee, B.J. Gill (Convener) 2010"
"Notiomystidae"	"Stitchbird"	"PHY"	"Stitchbird is related to the wattled crows of New Zealand, not to honyeaters (Meliphagidae) (Driskell et al 2007)"
"Psophodidae"	"Whipbirds, Jewel-babblers and Quail-thrushes"	"TAX, SEQ"	"Psophodidae provisionally includes Ptilorrhoa and Cinclosoma formerly in Eupetidae following Christidis and Boles (2008); should be separated to the Cinclosomatidae (Norman et al 2009)"
"Platysteiridae"	"Wattle-eyes, Batises"	"."	"."
"Tephrodornithidae"	"Woodshrikes and allies"	"TAX"	"Move Tephrodornis and Philentoma from Incertae Sedis to a new shrike family the Tephrodornithidae (Moyle et al 2006)"
"Prionopidae"	"Helmetshrikes"	"."	"."
"Malaconotidae"	"Bushshrikes"	"."	"."
"Machaerirhynchidae"	"Boatbills"	"PHY"	"Boatbills may belong to the woodswallow - bushshrike assemblage with Peltops (Norman et al. 2009)"
"Vangidae"	"Vangas"	"."	"."
"Cracticidae"	"Butcherbirds and allies"	"."	"."
"Pityriaseidae"	"Bristlehead"	"."	"."
"Artamidae"	"Woodswallows"	"PHY"	"Woodswallows are members of a larger assemblage that includes butcherbirds, peltops, bushshrikes, boatbills, and cuckooshrikes (Norman et al 2009)"
"Aegithinidae"	"Ioras"	"."	"."
"Campephagidae"	"Cuckooshrikes"	"."	"."
"Mohouidae"	"Whiteheads"	"PHY, TAX"	"Change status of Mohoua species (including Finschia) from Incertae sedis to follow Campephagidae as a monophyletic family in core Corvoidea (Aidala et al 2013)"
"Neosittidae"	"Sittellas"	"."	"."
"Incertae Sedis 2"	"Family Uncertain"	"."	"."
"Pachycephalidae"	"Whistlers and allies"	"PHY,TAX"	"Its composition in flux, Pachycephalidae includes Colluricincla, but excludes Oreoica, Rhagologus, and Pitohui sensu stricto (moved to Oriolidae) (Jønsson et al 2008, Dumbacher 2008); also remove Hylocitrea, a bombycillid (Spellman et al. 2008). Falcunculus is a questionable member of Pachycephalidae (Zuccon & Ericson, 2012)"
"Laniidae"	"Shrikes"	"."	"."
"Vireonidae"	"Vireos, Greenlets"	"TAX"	"Vireonidae includes Erpornis and Pteruthius (Reddy and Cracraft 2007, Reddy 2008)"
"Oriolidae"	"Figbirds, Orioles"	"PHY, SEQ"	"see Jønsson et al 2010 for phylogenetic sequence of species"
"Dicruridae"	"Drongos"	"."	"."
"Rhipiduridae"	"Fantails"	"."	"."
"Monarchidae"	"Monarchs"	"."	"."
"Corvidae"	"Crows, Jays"	"."	"."
"Corcoracidae"	"Australian Mudnesters"	"."	"."
"Incertae Sedis 3"	"Family Uncertain"	"."	"."
"Paradisaeidae"	"Birds-of-paradise"	"."	"."
"Petroicidae"	"Australasian Robins"	"."	"."
"Picathartidae"	"Rockfowl"	"PHY"	"Rockfowl, rockjumpers, and rail-babbler form an ancient clade that is sister to the Petroica and in turn to the Passerida (Jønsson et al. 2007)"
"Chaetopidae"	"Rockjumpers"	"."	"."
"Eupetidae"	"Rail-babbler"	"PHY, SEQ"	"Restrict Eupetidae to Rail-babbler Eupetes; resequence as sister to Chaetops and in turn to Picathartes (Jønsson et al. 2007)"
"Bombycillidae"	"Waxwings"	"."	"."
"Ptiliogonatidae"	"Silky-flycatchers"	"TAX"	"Follow AOU 1998 in recognizing silky flycatchers as a separate family Ptiliogonatidae. Change spelling to follow original spelling of genus Ptiliogonys."
"Hypocoliidae"	"Hypocolius"	"TAX"	"Separate Grey Hypocolius as monotypic family Hypocoliidae to be consistent with treatment of other enigmatic waxwing relatives"
"Dulidae"	"Palmchat"	"."	"."
"Mohoidae"	"Oos"	"PHY, SEQ"	"Species of Moho are related to waxwings (Bombycillidae), not to honeyeaters (Meliphagidae) (Fleischer et al. 2008)"
"Hylocitreidae"	"Hylocitrea"	"."	"."
"Stenostiridae"	"Fairy Flycatchers"	"TAX"	"Stenostiridae includes Stenostira and Elminia from Incertae Sedis and Culicicapa from Muscicapidae (Barker et al. 2002, 2004; Beresford et al. 2005; Fuchs et al. 2006)"
"Paridae"	"Tits, Chickadees"	"PHY, TAX"	"Revised classification follows Johansson et al 2013; see also Tietze & Borthakur 2012"
"Remizidae"	"Penduline Tits"	"."	"."
"Nicatoridae"	"Nicators"	"PHY, SEQ"	"Move Nicator species from Incertae Sedis to Nicatoridae, which aligns with Alaudidae and Panuridae to form a basal trichotomy that is sister of the rest of the sylvioids (Beresford et al 2005, Johansson et al 2008)"
"Panuridae"	"Bearded Reedling"	"PHY, SEQ"	"Bearded Reedling is not related to parrotbills, but is sister to the larks (Alaudidae) and in turn to the rest of the Sylvioidea (Ericson and Johansson 2003; Alström et al. 2006; Fuchs et al. 2006; Alström et al. 2013)"
"Alaudidae"	"Larks"	"."	"."
"Pycnonotidae"	"Bulbuls"	"."	"."
"Hirundinidae"	"Swallows, Martins"	"."	"."
"Pnoepygidae"	"Wren-babblers"	"TAX"	"Pnoepyga wren-babblers are not babblers and elevated to their own family (Gelang et al. 2009)"
"Macrosphenidae"	"Crombecs, African Warblers"	"TAX"	"See Fregin et al 2012 for formal proposal of Macrosphenidae, which Includes members of the Sphenoeacus group of Old World warblers separated by Johansson et al (2008)"
"Cettiidae"	"Cettia Bush Warblers and allies"	"PHY"	"Classification of Cettiidae revised (2.11) to follow Alström et al 2011b"
"Scotocercidae"	"Streaked Scrub Warbler"	"."	"."
"Erythrocercidae"	"Yellow Flycatchers"	"."	"."
"Incertae Sedis 4"	"Family Uncertain"	"."	"."
"Aegithalidae"	"Bushtits"	"TAX, ENG"	"The Aegithalidae are not closely related to the true tits (Paridae) as once thought (Harrap 2008); hence IOC recommended use of distinguishing name ""bushtit"" rather than ""tit"""
"Phylloscopidae"	"Leaf Warblers and allies"	"TAX"	"Many species of Phylloscopus leaf warblers belong in Seicercus (Johansson et al. 2007, Olsson et al. 2005 Boyd TiF website), but we await the results of a new multilocus analysis of the structure of the Phylloscopidae now underway (Alstrom)"
"Acrocephalidae"	"Reed Warblers and allies"	"."	"."
"Locustellidae"	"Grassbirds and allies"	"PHY, TAX"	"Locustellidae has priority over Megaluridae (Bock 1994, BOU); revised classification (v2.11 )includes  14 species transferred from Bradypterus ( Alström et al 2011a)"
"Donacobiidae"	"Black-capped Donacobius"	"PHY"	"Donacobius is related to the Old World warblers,not wrens (Troglodytidae);  treated for now as a monotypic family Donacobiidae (Aleixo and Pacheco 2006; SACC 293) pending resolution of relationships to Megaluridae vs Berneiridae (Johansson et al 2008)"
"Bernieridae"	"Malagasy Warblers"	"."	"."
"Cisticolidae"	"Cisticolas and allies"	"."	"."
"Timaliidae"	"Babblers"	"."	"."
"Pellorneidae"	"Fulvettas, Ground Babblers"	"TAX"	"Major clade of babblers treated provisionally as the family Pellorneidae pending full revision"
"Leiothrichidae"	"Laughingthrushes"	"TAX"	"Major clade of babblers treated provisionally as the family Leiothrichidae pending full revision"
"Sylviidae"	"Sylviid Babblers"	"TAX"	"Major clade of babblers treated provisionally as the family Sylviidae pending full revision"
"Zosteropidae"	"White-eyes"	"PHY, TAX"	"White-eyes consitute a major clade of babblers that includes Yuhina (Cibois et al. 2003); retain as family Zosteropidae pending full revision of babbler taxa"
"Arcanatoridae"	"Dapple-throat and allies"	"TAX"	"Promeropidae and Arcanatoridae are basal branches that each go further back in time than almost any other extant lineage in the Passerida. Best to treat them as two families pending evidence of their sister relateionship (Johansson et al 2008a Fjeldså, July 2012)"
"Promeropidae"	"Sugarbirds"	"."	"."
"Irenidae"	"Fairy-bluebirds"	"."	"."
"Regulidae"	"Goldcrests, Kinglets"	"."	"."
"Hyliotidae"	"Hyliotas"	"PHY"	"Move Hyliotas from the Sylviidae to their own family Hyliotidae, a basal lineage of the Passerida without known modern relatives (Fuchs et al 2006; TOL)"
"Troglodytidae"	"Wrens"	"."	"."
"Polioptilidae"	"Gnatcatchers"	"."	"."
"Sittidae"	"Nuthatches"	"."	"."
"Tichodromidae"	"Wallcreeper"	"."	"."
"Certhiidae"	"Treecreepers"	"."	"."
"Mimidae"	"Mockingbirds, Thrashers"	"."	"."
"Sturnidae"	"Starlings, Rhabdornis"	"TAX"	"Includes major revisions of genera by Lovette et al (2008), Zuccon et al (2008)"
"Buphagidae"	"Oxpeckers"	"PHY"	"Separate the oxpeckers from the Sturnidae to the Buphagidae; they are sister to the starlings (Mimidae) and mockingbirds (Mimidae) (Lovette and Rubenstein 2007)"
"Turdidae"	"Thrushes"	"."	"."
"Muscicapidae"	"Chats, Old World Flycatchers"	"PHY, TAX"	"See Sangster et al 2010, Zuccon & Ericson 2010 for revisions of Muscicapidae"
"Cinclidae"	"Dippers"	"."	"."
"Chloropseidae"	"Leafbirds"	"."	"."
"Dicaeidae"	"Flowerpeckers"	"."	"."
"Nectariniidae"	"Sunbirds"	"."	"."
"Passeridae"	"Old World Sparrows, Snowfinches"	"."	"."
"Ploceidae"	"Weavers, Widowbirds"	"."	"."
"Estrildidae"	"Waxbills, Munias and allies"	"."	"."
"Viduidae"	"Indigobirds, Whydahs"	"."	"."
"Peucedramidae"	"Olive Warbler"	"PHY, SEQ"	"Olive Warbler Peucedramus of New World most closely related to accentors (Prunellidae) (Ericson and Johansson 2003, Jønsson  and Fjeldså 2006)"
"Prunellidae"	"Accentors"	"."	"."
"Motacillidae"	"Wagtails, Pipits"	"."	"."
"Urocynchramidae"	"Przevalski's Finch"	"."	"."
"Fringillidae"	"Finches"	"TAX,PHY"	"Classification of Fringillidae revised for v3.3; see especially Zuccon et al 2012"
"Parulidae"	"New World Warblers"	"PHY, TAX"	"Genera and species sequences follow Lovette et al 2010 and AOU/NACC 2011 (supplement)"
"Incertae Sedis 5"	"Family Uncertain"	"."	"."
"Icteridae"	"Oropendolas, Orioles and Blackbirds"	"."	"."
"Coerebidae"	"Bananaquit"	"."	"."
"Emberizidae"	"Buntings, New World Sparrows and allies"	"."	"."
"Thraupidae"	"Tanagers and allies"	"."	"."
"Calcariidae"	"Longspurs, Snow Buntings"	"TAX, SEQ"	"Move longspurs Calcarius and snow buntings Plectrophenax from Emberizidae to their own family Calcariidae (Alström et al 2008)"
"Cardinalidae"	"Cardinals, Grosbeaks and allies"	"."	"."
